1
7
7
2
. . . . . . .
. . C . . . M
. . C . . O .
. M . . . O .
. . . . . . .
M . . . M M .
. . P . . . . 