2
19
11
6
....#####..........
....#...#..........
....#$..#..........
..###..$##.........
..#..$.$.#.........
###.#.##.#...######
#...#.##.#####..oo#
#.$..$........@.oo#
#####.###.#.##..oo#
....#.....#########
....#######........