5
17
13
3
........#####....
........#...#####
........#.#*##..#
........#.....*.#
#########.###...#
#oooo$.##.*..*###
#oooo$...*.**.##.
#oooo$.##*..*.@#.
#########..*..##.
........#.*.*..#.
........###.##.#.
..........#....#.
..........######.