5
17
13
12
........#####....
........#...#####
........#.#$##..#
........#.....$.#
#########.###...#
#oooo..##.$..$###
#oooo....$.$$.##.
#oooo..##$..$.@#.
#########..$..##.
........#.$.$..#.
........###.##.#.
..........#....#.
..........######.