1
19
11
2
....#####..........
....#...#..........
....#*..#..........
..###..*##.........
..#..*.*.#.........
###.#.##.#...######
#...#.##.#####..oo#
#.*..*........@$oo#
#####.###.#.##.$oo#
....#.....#########
....#######........