4
19
14
20
...........########
...........#..oooo#
############..oooo#
#....#..$.$...oooo#
#.$$$#$..$.#..oooo#
#..$.....$.#..oooo#
#.$$.#$.$.$########
#..$.#.....#.......
##.#########.......
#....#....##.......
#.....$...##.......
#..$$#$$..@#.......
#....#....##.......
###########........