3
17
10
11
........########.
........#.....@#.
........#.$#$.##.
........#.$..$#..
........##$.$.#..
#########.$.#.###
#oooo..##.$..$..#
##ooo....$..$...#
#oooo..##########
########.........