2
14
10
2
############..
#oo..#.....###
#oo..#.*..*..#
#oo$.#*####..#
#oo$...@.##..#
#oo..#.#..*.##
######.##..*.#
..#.*..*.*.*.#
..#....#.....#
..############