2
14
10
10
############..
#oo..#.....###
#oo..#.$..$..#
#oo..#$####..#
#oo....@.##..#
#oo..#.#..$.##
######.##$.$.#
..#.$..$.$.$.#
..#....#.....#
..############